    #####
    #   #
    #   #
  ###   ##
  #      #
### # ## #   ######
#   # ## #####    #
# $              .#
##### ### #@##    #
    #     #########
    #######
; 1


############
#..  #     ###
#..  # $     #
#..  # ####  #
#..    @ ##  #
#..  # #    ##
###### ##    #
  #          #
  #    #     #
  ############
; 2