    #####
    #   #
    #   #
  ###   ##
  #      #
### # ## #   ######
#   # ## #####    #
#  $             .#
##### ### #@##    #
    #     #########
    #######
; 1


############
#    #     ###
#    # $     #
#    # ####  #
#.     @ ##  #
#    # #    ##
###### ##    #
  #          #
  #    #     #
  ############
; 2